合著	合著
鉅著	鉅著
巨著	巨著
昭著	昭著
顯著	顯著
著錄	著錄
著志	著志
著稱	著稱
著述	著述
著書	著書
著名	著名
名著	名著
著作	著作
著者	著者
著於	著於
著白	著白
著式	著式
凶吉	凶吉
吉凶	吉凶
凶年	凶年
凶事	凶事
凶信	凶信
凶兆	凶兆
凶地	凶地
凶多吉少	凶多吉少
凶宅	凶宅
凶歲	凶歲
凶德	凶德
凶怪	凶怪
凶日	凶日
凶服	凶服
凶死	凶死
凶氣	凶氣
凶煞	凶煞
凶燄	凶燄
凶禮	凶禮
凶神	凶神
凶豎	凶豎
凶耗	凶耗
凶肆	凶肆
凶荒	凶荒
凶訊	凶訊
凶身	凶身
凶逆	凶逆
凶門	凶門
四凶	四凶
大凶	大凶
歲凶	歲凶
閔凶	閔凶
逢凶	逢凶
避凶	避凶